{
  "id":"FR-001",
  "name":"Toxic Sewers",
  "tileSize":42,
  "spawn":{"x":2,"y":2},
  "legend":{"#":"Wall",".":"Floor","C":"Cache","K":"Keycard","D":"Locked Door","S":"Save Terminal","H":"Heal Station","L":"Lore Terminal","E":"Anomaly","B":"Boss","X":"Exit"},
  "layout":[
    "############################",
    "#..S....E....#.......C....X#",
    "#..####......#..#####..#####",
    "#..#..C......#......#......#",
    "#..#.....E...####...#..E...#",
    "#..#.............#..#......#",
    "#..######..H.....#..####D###",
    "#.........#####..#......B..#",
    "#....L....#...#..#.........#",
    "############################"
  ]
}
