{
  "id": "toxic_sewers_01",
  "name": "Chapter 1: Toxic Sewers",
  "tileSize": 42,
  "legend": {
    "#": "wall",
    ".": "floor",
    "P": "player",
    "C": "chest",
    "E": "enemy",
    "B": "boss",
    "D": "door",
    "K": "key",
    "N": "npc"
  },
  "rows": [
    "########################",
    "#P....C......#.........#",
    "#..####..E...#..C......#",
    "#...........###........#",
    "#..E.....K.......####..#",
    "#..........#####.......#",
    "#....####...........E..#",
    "#....#..C.....N........#",
    "#....#.............#####",
    "#........#####.........#",
    "#..####......#.........#",
    "#.........C..#....B.D..#",
    "########################"
  ]
}